00000000000000000000000000000000000000000000000000000000000000000000000000000000
00000000011000000000000000000000000000000000000000000000000000000000011000000000
00000000111100000000000000000000000000000000000000000000000000000000111100000000
00000001111110000000000000000000000000000000000000000000000000000001111110000000
00000011111111000000000000000000000000000000000000000000000000000011111111000000
00000111111111100000000000000000000000000000000000000000000000000111111111100000
00000100000000100000000000000000000001100000000000000000000000000100000000100000
00000100000000100000000000000000000011110000000000000000000000000100000000100000
00000100000000100000000000000000000111111000000000000000000000000100000000100000
00000100000000100000000000000000001111111100000000000000000000000100000000100000
00000100000000100000000000000000011111111110000000000000000000000100000000100000
00000111000011100000000000000000111111111111000000000000000000000111000011100000
00000000000000000000000000000001111111111111100000000000000000000000000000000000
00000000000000000000000000000011111111111111110000000000000000000000000000000000
00000000000000000000000000000111111111111111111000000000000000000000000000000000
00000000000000000000000000001111111111111111111100000000000000000000000000000000
00000000000000000000000000001000000000000000000100000000000000000000000000000000
00000000000000000000000000001000000000000000000100000000000000000000000000000000
00000000000000000000000000001000000000000000000100000000000000000000000000000000
00000000000000000000000000001000000000000000000100000000000000000000000000000000
00000000000000000000000000001000000000000000000100000000000000000000000000000000
00000000000000000000000000001000000000000000000100000000000000000000000000000000
00000000000000000000000000001000000000000000000100000000000000000000000000000000
00000000000000000000000000001000000000000000000100000000000000000000000000000000
00000000000000000000000000001000000000000000000100000000000000000000000000000000
00000000000000000000000000001111111000000111111100000000000000000000000000000000
00000000000000000000000000000000000000000000000000000000000000000000000000000000
00000000000000000000000000000000000000000000000000000000000000000000000000000000
00000000000000000000000000000000000000000000000000000000000000000000000000000000
00000000000000000000000000000000000000000000000000000000000000000000000000000000
00000000000000000000000000000000000000000000000000000000000000000000000000000000
00000000000000000000000000000000000000000000000000000000000000000000000000000000
00000000000000000000000000000000000000000000000000000000000000000000000000000000
00000000000000000000000000000000000000000000000000000000000000000000000000000000
00000000000000000000000000000000000000000000000000000000000000000000000000000000
00000000000000000001111100000000000000000000000000000011111000000000000000000000
00000000000000000001000000000000000000000000000000000000001000000000000000000000
00000000000000000001000000000000000000000000000000000000001000000000000000000000
00000000000000000001000000000000000000000000000000000000001000000000000000000000
00000000000000000001111111111111111111111111111111111111111000000000000000000000